[
    {
        "name": "Test Level",
        "map": [
            "....................",
            "....................",
            "....................",
            "....................",
            "....................",
            "....................",
            "....................",
            "....................",
            "....................",
            "....................",
            ".................###",
            ".................###",
            "..............######",
            "..1..2...###########",
            "####################"
        ]
    }
]
